D31300364
D32000074
D33300075
D34033533
S31730005
S32630034
S33303353
S34700004
T31000704
T32003634
T33000735
T34335303
R31007004
R32353033
R33007305
R34036304
E31363004
E32070004
E33073005
E34530333
