D11011110
D12012110
D13310010
D14022010
D15020020
D16002010
D17004001
D18030000
S11101110
S12101210
S13013100
S14102200
S15002020
S16100020
S17000401
S18000030
T11121100
T12111100
T13001310
T14220100
T15202000
T16002100
T17003000
T18040001
R11211010
R12111010
R13100130
R14200200
R15021000
R16400001
R17300000
R18201020
E11110110
E12110120
E13130100
E14010220
E15020200
E16210000
E17000300
E18000041
