D21003221
D22230301
D23001422
D24000532
D25000502
D26600003
S21022301
S22023031
S23530002
S24200142
S25060003
S26050002
T21303021
T22014202
T23320201
T24005302
T25500002
T26000063
R21202031
R22032031
R23140202
R24300052
R25000052
R26000603
E21005002
E22053002
E23006003
E24230021
E25302301
E26420012
